111111111111111111
1P010000001000M001
1000000C00100C0001
100001000000000001
111000C11110C100M1
1C00M000001111C001
1000000C000C0000E1
111111111111111111
