11111111111
1P00C0M00E1
1C000011001
111100MC001
1C00C000111
11111111111
