111111111111111111111111111111111
1P00C0MC0000C000C000M000C00M00001
100010000100000000000000000000001
1000100M0100000000100001000111111
1010M00C000101000000001000M000001
10000000000000001111C10000000C001
1000M000C100010010000000000000001
10001000110000111000M000010000011
1000100010C000000000000000M000111
100010111111000M000011100C0000001
100000001001000000000100C10110101
1000000000C1000000000100110M00001
10C11111111C010000M000000C0000001
100000E0000M0100C00000M0000000011
111111111111111111111111111111111
